100
0 0 1 0 1 0 0 0 1 0 1 0 1 1 0 1 0 1 0 0 1 0 0 1 0 1 0 0 0 1 0 1 0 0 1 0 0 1 0 0 1 0 0 0 1 0 0 1 1 1 0 0 1 0 1 0 0 0 1 0 0 1 0 0 0 1 1 0 0 1 0 0 0 1 0 0 0 0 1 1 0 1 0 0 1 0 0 0 1 0 1 0 1 0 0 0 1 0 1 0
0 1 0 0 0 0 1 1 0 0 0 1 0 0 0 0 0 0 1 0 0 0 0 0 1 0 0 1 1 0 0 0 0 0 0 0 1 4 4 0 0 0 1 1 0 0 0 1 0 0 1 0 0 1 0 0 1 1 0 0 1 0 0 1 1 0 0 1 1 0 0 1 1 0 0 1 1 1 0 0 1 0 0 1 0 1 1 0 0 0 0 1 0 4 1 0 0 1 0 0
1 0 0 1 0 0 0 0 0 0 1 0 0 0 4 4 4 0 0 0 0 0 1 1 0 1 0 0 0 0 0 0 0 4 4 0 0 2 2 0 0 4 0 0 0 0 0 0 0 0 1 0 0 0 1 2 0 0 0 0 0 0 3 0 0 0 4 0 3 0 0 0 4 4 0 0 0 0 0 0 0 0 0 0 0 0 0 0 0 4 0 0 1 2 0 0 0 0 0 7
1 0 0 0 0 0 0 0 0 0 0 4 4 3 0 0 1 3 4 4 0 0 0 0 0 0 0 0 1 1 1 0 0 0 3 0 0 0 0 0 1 0 0 1 0 0 1 0 2 3 3 3 4 4 3 2 0 0 4 4 0 0 0 3 4 4 3 3 2 4 0 0 0 0 0 0 0 0 0 1 0 4 4 4 4 0 0 0 0 2 0 0 0 0 0 0 0 2 2 2
0 0 0 0 0 0 0 1 1 0 0 4 0 2 3 3 3 2 0 0 0 0 0 0 1 1 0 0 0 0 0 0 0 0 2 4 4 4 0 0 0 0 1 0 0 0 0 1 2 2 2 2 2 2 2 2 1 0 0 4 2 2 2 2 2 2 2 2 2 0 0 1 0 0 0 0 0 0 0 0 0 2 3 3 3 4 2 0 0 4 0 0 0 0 0 0 1 0 0 1
0 0 1 0 0 0 0 0 0 0 0 0 0 2 2 2 2 2 0 0 0 0 0 0 0 0 1 0 0 0 0 0 1 0 0 3 4 4 4 4 0 3 0 0 0 0 0 0 0 0 0 1 0 1 1 0 0 0 0 0 0 0 0 0 0 0 0 0 0 0 0 2 3 4 4 0 0 0 0 0 0 2 2 2 2 2 2 0 0 0 0 1 0 0 0 0 0 0 0 1
0 0 0 1 1 0 4 0 0 0 0 3 0 0 0 0 0 0 0 0 4 4 0 0 0 0 0 4 0 0 0 0 0 0 0 2 3 3 3 0 0 2 0 0 1 4 3 0 0 0 0 0 0 0 0 0 0 4 0 0 0 0 0 0 1 0 0 0 0 0 0 2 2 2 0 0 0 4 0 0 0 0 0 0 1 0 0 0 0 3 0 0 0 1 1 0 0 0 0 0
1 0 0 0 0 0 0 1 0 0 4 2 3 4 2 0 0 0 0 0 0 0 0 3 4 0 0 0 0 0 1 1 1 0 0 2 2 2 2 2 2 2 1 4 0 1 2 4 4 0 0 1 0 0 0 0 3 0 0 0 0 0 0 0 0 0 0 0 0 1 0 0 0 0 0 0 0 3 4 0 3 0 0 0 4 0 0 0 0 2 0 0 0 0 0 0 0 1 0 0
0 0 1 0 1 0 1 0 4 0 0 2 2 2 2 0 0 0 1 1 0 0 0 0 0 0 4 3 3 4 0 0 0 1 0 0 0 0 0 0 0 0 0 4 0 0 2 3 3 3 4 4 4 5 0 0 2 0 0 4 4 0 0 0 1 0 0 0 0 0 0 0 0 0 0 0 0 2 3 3 2 0 0 0 1 4 0 0 0 0 0 0 0 0 0 0 0 0 0 0 
3 3 0 0 4 0 0 3 3 0 0 0 0 4 4 5 0 3 0 0 0 3 4 0 0 0 0 0 0 0 2 3 3 4 0 4 4 4 0 0 0 0 3 3 0 0 2 2 2 2 2 2 2 2 2 2 2 0 0 3 3 0 0 0 4 4 0 0 0 0 0 4 0 0 0 0 0 2 2 2 2 0 0 2 3 3 3 4 4 4 0 2 0 1 0 0 0 0 0 4
3 3 3 4 4 0 0 2 2 3 3 3 2 0 0 3 2 2 0 0 0 2 2 2 2 2 2 2 2 2 2 2 2 2 3 3 3 0 0 0 3 3 2 2 0 0 0 0 0 1 1 0 0 0 0 0 1 0 0 2 2 3 4 4 4 3 5 3 3 3 0 0 4 2 0 0 0 0 0 0 0 0 0 2 2 2 2 2 2 2 2 2 0 0 0 0 3 3 4 4
2 2 2 2 2 0 0 2 2 2 2 2 2 0 0 2 2 2 0 0 0 2 2 2 2 2 2 2 2 2 2 2 2 2 2 2 2 2 2 2 2 2 2 2 0 0 0 0 0 0 0 0 0 0 0 0 0 0 0 2 2 2 2 2 2 2 2 2 2 2 2 2 2 2 0 0 0 0 0 0 0 0 0 0 0 0 0 0 0 0 0 0 0 0 0 0 2 2 2 2
9
10 11
9 28
10 39
9 51
7 39
4 54
4 65
10 87
10 69