75
0 0 0 1 1 0 1 1 0 0 0 1 0 1 0 0 1 0 1 0 1 0 1 1 0 0 0 1 0 1 0 1 0 1 0 1 0 1 0 1 0 1 0 1 0 1 0 1 0 0 0 0 2 2 2 1 1 0 1 0 1 0 0 1 0 0 0 0 1 2 2 2 2 2 2                                                                  
0 0 0 0 1 0 0 0 0 0 0 0 0 0 0 0 0 0 0 0 0 0 0 0 0 1 1 0 4 4 0 1 0 0 0 0 0 0 0 0 0 0 0 0 0 0 0 0 0 0 0 1 0 0 1 0 0 0 0 0 1 0 0 0 0 0 0 0 0 0 0 0 0 0 0
0 0 0 0 1 0 1 0 1 0 1 0 1 0 1 0 0 0 0 0 0 1 0 0 0 4 0 0 0 0 0 0 1 0 1 0 1 0 1 0 1 0 0 1 0 0 1 0 0 0 0 0 0 4 0 0 1 0 0 0 0 1 0 1 0 0 1 0 0 0 0 2 2 0 0
0 0 1 0 0 1 0 0 1 0 0 1 0 1 0 0 0 0 1 4 0 0 0 0 4 4 4 6 4 1 0 0 0 0 0 1 0 0 0 0 1 0 0 0 1 4 0 0 0 4 4 1 0 2 0 0 4 0 0 0 0 0 0 0 4 0 4 0 0 0 2 0 0 0 7
0 0 0 0 1 0 1 0 1 1 0 1 1 0 1 0 0 0 0 2 0 4 0 4 2 2 2 2 2 2 1 0 1 0 1 0 0 0 0 1 0 0 0 3 4 4 0 1 0 0 0 0 0 1 0 1 4 0 0 0 0 0 0 0 0 0 0 1 0 0 0 0 1 2 2
0 1 0 0 0 0 1 4 0 0 0 0 0 0 0 1 0 0 1 0 1 0 1 0 0 1 0 1 0 1 4 1 0 0 0 0 0 0 0 0 0 0 2 2 0 0 0 0 0 1 0 0 1 0 1 1 4 0 0 0 1 4 4 6 1 0 1 0 2 2 0 0 0 0 0                                                    
0 0 0 0 0 1 4 4 4 0 1 0 1 0 1 0 1 1 2 1 0 0 1 2 0 0 0 0 0 1 2 1 0 0 1 0 0 0 0 0 4 5 0 2 0 0 0 1 0 0 1 0 2 0 2 0 0 0 0 0 0 0 0 2 0 0 0 2 1 0 0 0 1 1 0                          
0 0 1 1 1 6 0 0 0 0 0 0 0 0 0 6 4 4 0 0 0 2 4 2 0 1 0 1 0 1 0 6 0 6 3 0 0 0 3 2 3 3 3 2 2 2 0 0 0 0 2 0 0 0 0 0 0 0 6 4 0 4 4 2 3 3 3 2 0 0 0 0 2 0 0
0 0 0 0 0 2 0 0 0 0 0 0 0 0 0 2 2 2 0 0 0 2 2 2 2 2 1 0 0 0 0 2 0 2 2 2 0 0 2 2 2 2 2 2 0 0 0 1 0 0 0 0 0 0 0 0 0 1 2 3 3 3 6 2 2 2 2 2 0 0 4 0 2 0 0  
0 0 0 0 0 2 0 0 0 0 0 0 0 0 0 2 0 0 0 0 0 2 0 0 0 0 0 0 0 0 0 0 0 2 0 4 2 0 2 0 0 0 0 0 0 0 0 0 0 2 0 0 0 1 0 0 0 0 2 2 2 2 2 2 0 0 0 0 0 0 2 0 2 1 0
3 6 3 6 4 2 4 0 5 3 3 3 6 6 6 2 6 6 6 6 3 2 3 3 3 4 3 4 3 3 3 3 3 2 3 6 6 3 2 4 4 3 3 0 3 6 6 6 2 0 0 0 0 0 6 0 6 0 2 3 3 4 3 3 3 3 4 0 0 0 0 0 2 3 0
2 2 2 2 2 2 2 2 2 2 2 2 2 2 2 2 0 2 0 2 2 2 2 2 2 2 2 2 2 2 2 2 2 2 0 2 2 2 2 2 2 2 2 2 2 2 2 2 2 2 0 0 2 0 2 0 2 2 2 2 2 2 2 2 2 2 2 2 2 2 2 2 2 2 0
6
7 15
10 32
8 43
8 62
10 65
7 66






